10 7 0.7
2 3 4 5 6 2 3
2 3 4 5 6 2 3
2 3 4 5 6 2 3
0 0 0 0 0 0 0 
2 0 0 0 0 0 3
2 3 0 0 0 2 3
2 3 4 0 5 2 3
0 0 0 0 0 0 3
0 0 0 0 0 0 3
1 1 0 1 0 1 1